8 7 2
#######
#G....#
#.....#
#..C..#
#O.@.O#
#.C...#
#....G#
#######