6 6 1
######
#..^G#
##.^^#
#.C..#
#...@#
######