6 5 1
#####
#G###
#.C.#
#.#.#
#@..#
#####
