10 8 4
##########
#G....C.G#
##......##
#...C....#
#...@....#
#.C.C....#
##......##
#G......G#
##########
